 1 18 32
20 14 14 14 14 14 14 14 14 14 14 14 14 19 14 14 14 14 14 14 14 14 14 14 14 14 14 14 14 14 14 19
21 02 02 00 00 00 00 02 02 00 00 00 02 21 00 00 00 02 00 00 02 00 00 02 02 00 03 02 02 00 00 21
21 07 07 07 07 07 07 07 07 07 07 07 07 21 07 07 07 07 07 07 07 07 07 07 07 07 07 07 07 07 07 21
21 07 07 07 07 07 07 07 07 07 07 07 07 17 07 07 07 07 07 07 07 07 07 07 07 07 28 07 07 07 07 21
21 07 07 07 07 07 07 04 04 07 07 07 07 02 07 07 07 07 07 07 07 07 07 07 07 07 07 07 07 07 07 21
17 07 07 07 07 07 07 25 25 07 07 07 07 07 07 07 07 07 07 07 07 07 07 07 20 13 13 13 13 13 13 19
02 07 07 07 07 07 07 25 26 07 07 07 07 07 07 07 07 07 07 07 07 07 07 07 21 00 00 00 00 00 00 06
01 01 01 01 01 01 01 25 25 01 01 01 01 01 01 01 01 01 01 01 01 01 01 07 17 10 11 11 11 10 10 10
25 25 25 25 25 25 25 25 25 25 25 25 25 25 25 25 25 25 25 25 25 25 25 07 02 25 25 26 25 25 25 25
25 25 25 25 25 25 25 25 25 25 25 25 25 25 25 25 25 25 19 14 14 14 19 07 07 20 19 25 25 25 25 25
25 25 25 25 25 25 25 25 25 25 25 25 25 25 25 25 25 25 21 02 02 02 02 07 07 02 21 25 25 25 25 25
25 25 25 25 25 25 25 25 25 25 25 25 25 25 25 25 25 25 21 07 07 07 07 07 07 07 21 25 25 25 25 25
25 25 25 25 25 25 25 25 26 25 25 25 25 25 25 25 25 25 21 07 07 07 07 07 28 07 21 25 25 25 25 25
25 25 25 25 25 25 25 25 25 25 25 25 25 25 25 25 25 25 21 07 07 07 07 07 07 07 16 14 14 14 14 19
25 25 25 25 25 25 25 25 25 25 25 25 25 25 25 25 25 25 21 07 07 07 07 07 07 07 02 02 02 02 02 21
25 25 25 25 25 25 25 25 25 25 25 25 25 25 25 25 25 25 21 07 07 07 07 07 07 07 07 07 07 07 07 21
25 25 25 25 25 25 25 25 25 25 25 25 25 25 25 25 25 25 16 14 14 14 14 14 14 14 19 13 13 13 13 19
25 25 25 25 25 25 25 25 25 25 25 25 25 25 25 25 25 25 00 00 00 00 00 00 00 00 00 11 11 11 11 11