1 7 25
7  1  1  1  1  1  1  1  1  1  1  1  6  1  1  1  1  1  1  1  1  1  1  1  6
9 10 10 10 10 10 10 10 10 10 10 10  9 10 10 10 10 10 10 10 10 10 10 10  9
9 11 11 11 11 11 11 11 11 11 11 11  9 11 11 11 11 11 11 11 11 11 11 11  9
9 11 11 11 11 11 11 11 11 11 11 11  4 11 11 11 11 11 11 11 11 11 11 11  9
9 11 11 11 11 11 11 11 11 11 11 11 10 11 11 11 11 11 11 11 11 11 11 11  4
9 11 11 11 11 11 11 11 11 11 11 11  0 11 11 11 11 11 11 11 11 11 11 11  0
9 11 11 11 11 11 11 11 11 11 11 11  0 11 11 11 11 11 11 11 11 11 11 11  0