2 35 36

w25    w25    w25    w25    w20    w14    w14    w14    w14    w14    w14    w14    w14    w14    w14    w14    w14    w14     w14    w14    w14    w14    w14    w14    w14    w14    w14    w14    w14    w14    w14    w19    w25    w25    w25    w25
w25    w25    w25    w25    w21    w0     w0     w0     w2     w0     w0     w0     w0     w2     w3     w0     w0     w2      w3     w2     w2     w3     w2     w0     w0     w0     w0     w0     w0     w0     w0     w21    w25    w25    w25    w25
w25    w25    w25    w25    w21    f7     f7     f7     f7     f7     e3-f7  o3-f7  o2-f7  o2-f7  f7     f7     f7     o3-f7   o3-f7  f7     f7     f7     f7     f7     o2-f7  f7     f7     f7     f7     f7     o2-f7  w21    w25    w25    w25    w25
w25    w25    w25    w25    w21    f7     f7     f7     e0-f7  f7     f7     f7     f7     f7     f7     e3-f7  e0-f7  f7      f7     e0-f7  f7     e3-f7  e3-f7  f7     o3-f7  f7     f7     f7     f7     o3-f7  o2-f7  w1     w25    w25    w25    w25
w25    w25    w25    w25    w21    f7     f7     w1     w1     w1     w1     w1     w1     w1     w1     w1     w1     w1      w1     w1     w1     w1     w1     w1     w1     w1     w1     w1     f23    f23    w1     w0     w25    w25    w25    w25
w25    w25    w25    w25    w5     o3-f7  o2-f7  w25    w25    w25    w25    w25    w25    w25    w25    w25    w25    w25     w25    w25    w25    w25    w25    w25    w25    w25    w25    w25    f23    f23    w25    w25    w25    w25    w25    w25
w25    w25    w25    w25    w25    f23    f23    w25    w25    w25    w25    w25    w25    w25    w25    w25    w25    w25     w25    w25    w25    w25    w25    w25    w25    w25    w25    w25    f23    f23    w25    w25    w25    w25    w25    w25
w25    w25    w25    w25    w25    f23    f23    w25    w25    w25    w25    w25    w20    w14    w14    w14    w14    w14     w14    w14    w14    w14    w14    w14    w14    w14    w19    w25    f23    f23    w25    w25    w25    w25    w25    w25
w25    w25    w25    w25    w25    f23    f23    w25    w25    w25    w25    w25    w21    w0     w0     w0     w0     w0      w0     w0     w0     w0     w0     w0     w0     w0     w21    w25    f23    f23    w25    w25    w25    w25    w25    w25
w25    w25    w25    w25    w25    f23    f23    w25    w25    w25    w25    w25    w21    o1-f7  o1-f7  e3-f7  f7     f7      f7     f7     f7     o3-f7  o3-f7  f7     o1-f7  f7     w21    w25    f23    f23    w25    w25    w25    w25    w25    w25
w25    w25    w25    w25    w25    f23    f23    w25    w25    w25    w25    w25    w21    o3-f7  o3-f7  f7     f7     f7      e2-f7  o3-f7  f7     f7     f7     f7     f7     f7     w21    w25    f23    f23    w25    w25    w25    w25    w25    w25
w25    w25    w25    w25    w25    f23    f23    w25    w25    w25    w25    w25    w21    f7     f7     f7     f7     o1-f7   f7     f7     f7     e1-f7  f7     f7     f7     f7     w21    w25    f23    f23    w25    w25    w25    w25    w25    w25
w25    w25    w25    w25    w25    o1-f23 o1-f23 w25    w25    w25    w25    w25    w21    f7     e3-f7  e2-f7  f7     o3-f7   f7     o3-f7  f7     f7     o3-f7  f7     f7     f7     w21    w25    f23    f23    w25    w25    w25    w25    w25    w25
w20    w14    w14    w14    w14    f7     f7     w25    w14    w14    w14    w14    w19    f7     e3-f7  f7     f7     o3-f7   f7     o3-f7  f7     f7     o3-f7  f7     o1-f7  o1-f7  w0     w25    f23    f23    w25    w25    w25    w25    w25    w25
w21    w0     w0     w0     w0     f7     f7     f7     w0     w0     w0     w0     w0     f7     f7     f7     f7     f7      f7     o3-f7  f7     f7     o3-f7  f7     w11    w10    w11    w25    f23    f23    w25    w25    w25    w25    w25    w25
w21    o2-f7  f7     f7     f7     e0-f7  e0-f7  f7     f7     o3-f7  f7     o1-f7  o0-f7  f7     f7     f7     f7     o1-f7   f7     f7     f7     f7     f7     f7     w25    w25    w25    w25    f23    f23    w25    w25    w25    w25    w25    w25
w21    o2-f7  f7     e3-f7  e3-f7  f7     f7     f7     f7     f7     f7     f7     o0-f7  f7     f7     f7     f7     o1-f7   f7     e1-f7  f7     o3-f7  f7     f7     f7     w25    w25    w25    f23    f23    w25    w25    w25    w25    w25    w25
w5     w1     w1     w1     w1     f7     f7     f7     w1     w1     w1     w1     w1     f7     f7     e0-f7  f7     f7      f7     f7     f7     f7     f7     o3-f7  f7     w25    w20    w14    f23    f23    w25    w14    w14    w14    w14    w19
w25    w25    w25    w25    w25    f7     f7     f7     w25    w25    w25    w25    w25    f7     o3-f7  o3-f7  o3-f7  e3-f7   f7     f7     f7     f7     f7     o3-f7  e3-f7  w26    w21    w0     o2-f23 o2-f23 o3-f7  w0     w2     w2     w0     w21
w25    w25    w25    w25    w25    f7     f7     e1-f7  w25    w25    w25    w25    w25    w1     w1     w1     w1     w1      f23    f23    w1     w1     w1     w1     w1     w25    w21    f7     f7     f7     f7     f7     f7     f7     f7     w21
w25    w25    w25    w25    w25    w4     f23    w4     w25    w25    w25    w25    w25    w25    w25    w25    w25    w25     f23    f23    w25    w25    w25    w25    w25    w25    w21    f7     f7     f7     f7     f7     f7     f7     f7     w21
w25    w25    w25    w25    w25    w25    f23    w25    w25    w25    w25    w25    w25    w25    w25    w25    w25    w25     f23    f23    w25    w25    w25    w25    w25    w25    w21    f7     f7     f7     e1-f7  f7     f7     f7     f7     w21
w25    w25    w25    w25    w25    w25    f23    w25    w25    w25    w25    w25    w25    w25    w25    w25    w25    w25     f23    f23    w25    w25    w25    w25    w25    w25    w21    f7     f7     f7     f7     f7     f7     f7     f7     w21
w25    w25    w25    w25    w25    w25    f23    w25    w25    w25    w25    w25    w25    w25    w25    w25    w25    w25     f23    o0-f23 w25    w25    w20    w14    w14    w14    w19    f7     f7     f7     f7     f7     f7     f7     f7     w21
w25    w25    w25    w25    w25    w25    f23    w25    w25    w25    w25    w25    w25    w25    w25    w25    w25    w25     f23    o0-f23 w25    w25    w0     w0     w0     w0     w0     f7     f7     o3-f7  o3-f7  o3-f7  e3-f7  f7     f7     w21
w25    w25    w25    w25    w25    w25    f23    w25    w25    w25    w25    w25    w25    w25    w25    w25    w25    w25     f23    o3-f23 w25    w25    o2-f7  o0-f7  o1-f7  e3-f7  f7     f7     f7     o3-f7  o2-f7  o2-f7  f7     f7     f7     w21
w25    w25    w25    w25    w25    w25    f23    w25    w25    w25    w25    w25    w25    w25    w25    w25    w25    w25     o0-f23 f23    w25    w25    o2-f7  o0-f7  o1-f7  f7     f7     f7     f7     o3-f7  o2-f7  o2-f7  f7     e0-f7  f7     w21
w25    w25    w25    w25    w25    w25    f23    w25    w25    w25    w25    w25    w25    w25    w25    w25    w25    w25     o0-f23 f23    w25    w25    o2-f7  o0-f7  o1-f7  e3-f7  f7     f7     f7     o3-f7  o3-f7  o3-f7  e3-f7  f7     f7     w21
w25    w25    w25    w25    w25    w25    f23    w25    w25    w25    w25    w25    w25    w25    w25    w25    w25    w25     f23    f23    w25    w25    o2-f7  o0-f7  o1-f7  f7     f7     f7     f7     f7     f7     f7     f7     f7     f7     w21
w25    w25    w25    w25    w25    w25    f23    w25    w25    w25    w25    w25    w25    w25    w25    w25    w25    w25     f23    f23    w25    w25    w14    w14    w14    w14    w19    f7     f7     f7     f7     f7     f7     f7     f7     w21
w25    w25    w25    w25    w25    w25    f23    w25    w25    w25    w25    w25    w25    w25    w25    w25    w25    w25     f23    f23    w25    w25    w1     w1     w1     w1     w21    f7     f7     f7     f7     f7     f7     f7     f7     w21
w25    w25    w25    w25    w25    w25    o2-f23 w25    w25    w25    w25    w25    w25    w25    w25    w25    w25    w25     f23    f23    w25    w25    w25    w25    w25    w25    w21    f7     f7     f7     f7     e1-f7  e0-f7  f7     o0-f7  w21
w25    w25    w25    w25    w25    w25    f23    w25    w25    w25    w25    w25    w25    w25    w25    w25    w25    w25     p0-f7  f7     w25    w25    w25    w25    w25    w25    w21    o0-f7  f7     f7     f7     f7     f7     f7     o0-f7  w21
w25    w25    w25    w25    w25    w14    w14    w14    w25    w25    w25    w25    w25    w25    w25    w25    w25    w14     w14    w14    w14    w25    w25    w25    w25    w25    w6     w14    w14    w14    w14    w14    w14    w14    w14    w19
w25    w25    w25    w25    w25    w0     w0     w0     w25    w25    w25    w25    w25    w25    w25    w25    w25    w0      w0     w0     w0     w25    w25    w25    w25    w25    w25    w11    w11    w11    w11    w11    w11    w11    w11    w11
